! 1
" 2
# 3
$ 4
% 5
& 6
' 7
( 8
) 9
* 10
+ 11
, 12
- 13
. 14
/ 15
0 16
1 17
2 18
map
//////////////////////////////////////////////////////////////////////
//////////////////////////////////////////////////////////////////////
//////////////////////////////////////////////////////////////////////
//////////////////////////////////////////////////////////////////////
/////////////////////0000000000000000000000000000000000000000000000000
/////////////////////0000000000000000000000000000000000000000000000000
/////////////////////0000000000000000000000000000000000000000000000000
/////////////////////0000000000000000000000000000000000000000000000000
/////////////////////0000000000000000000000000000000000000000000000000
/////////////////////0000000000000000000000000000000000000000000000000
/////////////////////0000000000000000000000000000000000000000000000000
/////////////////////0000000000000000000000000000000000000000000000000
/////////////////////0000000000000000000000000000000000000000000000000
/////////////////////0000000000000000000000000000000000000000000000000
/////////////////////0000000000000000000000000000000000000000000000000
/////////////////////0000000000000000000000000000000000000000000000000
/////////////////////0000000000000000000000000////////////////////////
/////////////////////0000000000000000000000000////////////////////////
/////////////////////0000000000000000000000000////////////////////////
/////////////////////0000000000000000000000000////////////////////////
/////////////////////0000000000000000000000000////////////////////////
/////////////////////0000000000000000000000000////////////////////////
/////////////////////0000000000000000000000000////////////////////////
/////////////////////0000000000000000000000000////////////////////////
/////////////////////0000000000000000000000000////////////////////////
/////////////////////0000000000000000000000000////////////////////////
/////////////////////0000000000000000000000000////////////////////////
/////////////////////0000000000000000000000000////////////////////////
/////////////////////0000000000000000000000000////////////////////////
/////////////////////0000000000000000000000000////////////////////////
/////////////////////0000000000000000000000000////////////////////////
/////////////////////0000000000000000000000000////////////////////////
/////////////////////0000000000000000000000000////////////////////////
/////////////////////0000000000000000000000000////////////////////////
/////////////////////0000000000000000000000000////////////////////////
/////////////////////0000000000000000000000000////////////////////////
/////////////////////0000000000000000000000000////////////////////////
/////////////////////0000000000000000000000000////////////////////////
/////////////////////0000000000000000000000000////////////////////////
/////////////////////0000000000000000000000000////////////////////////
/////////////////////0000000000000000000000000////////////////////////
/////////////////////0000000000000000000000000////////////////////////
/////////////////////0000000000000000000000000////////////////////////
/////////////////////0000000000000000000000000////////////////////////
/////////////////////0000000000000000000000000////////////////////////
/////////////////////0000000000000000000000000////////////////////////
/////////////////////0000000000000000000000000////////////////////////
/////////////////////0000000000000000000000000////////////////////////
/////////////////////0000000000000000000000000////////////////////////
/////////////////////0000000000000000000000000////////////////////////
/////////////////////0000000000000000000000000////////////////////////
/////////////////////0000000000000000000000000////////////////////////
/////////////////////0000000000000000000000000////////////////////////
/////////////////////0000000000000000000000000////////////////////////
/////////////////////0000000000000000000000000////////////////////////
/////////////////////0000000000000000000000000////////////////////////
/////////////////////0000000000000000000000000////////////////////////
/////////////////////0000000000000000000000000////////////////////////
/////////////////////0000000000000000000000000////////////////////////
/////////////////////0000000000000000000000000////////////////////////
/////////////////////0000000000000000000000000////////////////////////
/////////////////////0000000000000000000000000////////////////////////
/////////////////////0000000000000000000000000////////////////////////
/////////////////////0000000000000000000000000////////////////////////
/////////////////////0000000000000000000000000////////////////////////
/////////////////////0000000000000000000000000////////////////////////
/////////////////////0000000000000000000000000////////////////////////
/////////////////////0000000000000000000000000////////////////////////
/////////////////////0000000000000000000000000////////////////////////
/////////////////////0000000000000000000000000////////////////////////
/////////////////////0000000000000000000000000////////////////////////
/////////////////////0000000000000000000000000////////////////////////
/////////////////////0000000000000000000000000////////////////////////
/////////////////////0000000000000000000000000////////////////////////
/////////////////////0000000000000000000000000////////////////////////
/////////////////////0000000000000000000000000////////////////////////
/////////////////////0000000000000000000000000////////////////////////
/////////////////////0000000000000000000000000////////////////////////
/////////////////////0000000000000000000000000////////////////////////
/////////////////////0000000000000000000000000////////////////////////
/////////////////////0000000000000000000000000////////////////////////
/////////////////////0000000000000000000000000////////////////////////
/////////////////////0000000000000000000000000////////////////////////
/////////////////////0000000000000000000000000////////////////////////
/////////////////////0000000000000000000000000////////////////////////
/////////////////////0000000000000000000000000////////////////////////
/////////////////////0000000000000000000000000////////////////////////
/////////////////////0000000000000000000000000////////////////////////
/////////////////////0000000000000000000000000////////////////////////
/////////////////////0000000000000000000000000////////////////////////
/////////////////////0000000000000000000000000////////////////////////
/////////////////////0000000000000000000000000////////////////////////
/////////////////////0000000000000000000000000////////////////////////
/////////////////////0000000000000000000000000////////////////////////
/////////////////////0000000000000000000000000////////////////////////